it slipped my mind


get distracted - відволікатися
accompany - супроводжувати
exceptions - винятки
elaborate on my position from my perspective - детально розробити свою позицію з мого бачення
obstacle - перешкода
far from perfect - далекий від ідеального
I am far from finishing - Я далекий від завершення.
I am not even nearly close to finish it - Я навіть близько не близький до його завершення.
to convey the meaning - передати значення

take you seriously - вважати вас серйозно

top left corner - 
retell - 
subtle - 
remaining - 
Based on factors which you provided -
Based on - 
regardless of - 
Irrespective - 
I have got the impression that this estimate is incorect.
arrogance person - высокомерный человек
haughtiness persona - надменная личность
I appreciate 
strong - strength
long - length
deep - depth
high - height*
tension 
i don't mind 
i don't mind other people smoke 
i want you to do this work for me 
perceptive 

Doctors treat patients
He was treated kindly in his foster family
May I treat you to some coffee?
medical treatment
trick-or-treat
pet treats
I can tell what person you are when I see how you treat service workers
your loving has gone forever 



inconvenience - незручність
paintings are found on - малюнки знаходяться на
face it - стикаємося з цим
properly - належним чином
elaborate - докладний
when you judge the answers - коли ви оцінюєте відповіді
irreplaceable part of life - незамінна частина життя
pay attention to something - звернути увагу на щось
draw attention / birght colors draws ours attention - привертати увагу / яскраві кольори привертають нашу увагу
reliable - надійний
who I talk to - з ким я розмовляю
nail - цвях
partly - частково
no keen - не зацікавлений
dull - нудний
catchy - запам'ятовуючий, привабливий
gripping - захоплюючий
uplifting - піднімаючий настрій
over-the-top - надмірний, перебільшений
disturbing - тривожний
upsetting - обурливий
dreadful - жахливий
internal - внутрішній
now and again - час від часу
starters - початківці
hardly - мало, ще й
I hardly ever go to the cinema - я майже ніколи не ходжу в кіно
I will go to the concert - піду на концерт
fitter - більш підготовлений, спритніший
as much as i used to - так само, як раніше
I used to be fitter - раніше я був більш підготовлений
in this work you need to get used to programming on the old computers - у цій роботі вам потрібно звикнути програмувати на старих комп'ютерах
Correspondence - листування, переписка

standalone - автономный
compatibility - совместимость
implies - подразумевает
except the first one - кроме
evaluate - вплив
influence - the capacity to have an effect on the character - вплив - здатність впливати на характер
regularly - регулярно
it's frightening - це лякає
it would suit you - тобі це підійде
On one occasion - oдного разу
Although - хоча
conscious choice - свідомий вибір
top up your account - поповнити рахунок


life threatening - небезпечні для життя

more likely to be able - швидше за все, зможе
lucid - expressed clearly; easy to understand.
when gamers do have a nightmares - коли гравцям дійсно сняться кошмари


follow-up with - зв’яжіться з
please follow-up with Roksana once she's back from her PTO next week

i don't feel like going out;
i commute to the office in about 15 minutes;

to cope - впоратися
i try to cope with my mental problems;

